S***----
--**I---
---*---*
---*****
----*--F
